Date,Infected,Exposed,Active,Recovered,Deaths,Diff Exposed,Diff Active,Diff Recovered,Diff Deaths
2020-07-08,14,31,3,11,0,0,6,0,0
2020-07-09,19,25,8,11,0,0,4,1,0
2020-07-10,24,21,12,12,0,0,3,1,0
2020-07-11,28,17,15,13,0,0,2,1,0
2020-07-12,31,14,16,15,0,0,1,1,0
2020-07-13,33,12,17,16,0,0,1,2,0
2020-07-14,36,10,18,18,0,0,0,2,0
2020-07-15,38,8,18,20,0,0,0,2,0
2020-07-16,39,7,18,21,0,0,0,2,0
2020-07-17,41,6,18,23,0,0,0,2,0
2020-07-18,41,5,17,24,0,0,0,2,0
2020-07-19,43,5,17,26,0,0,0,2,0
2020-07-20,43,4,16,27,0,0,0,1,0
2020-07-21,44,3,15,29,0,0,0,1,0
2020-07-22,45,3,15,30,0,0,0,1,0
2020-07-23,46,3,14,32,0,0,0,1,0
2020-07-24,46,2,13,33,0,0,0,1,0
2020-07-25,46,2,12,34,0,0,0,1,0
2020-07-26,47,2,12,35,0,0,0,1,0
2020-07-27,47,2,11,36,0,0,0,1,0
2020-07-28,47,2,10,37,0,0,0,1,0
2020-07-29,48,1,10,38,0,0,0,1,0
2020-07-30,48,1,9,39,0,0,0,1,0
2020-07-31,49,1,9,40,0,0,0,1,0
2020-08-01,48,1,8,40,0,0,0,1,0
2020-08-02,49,1,8,41,0,0,0,1,0
2020-08-03,49,1,7,42,0,0,0,1,0
2020-08-04,49,1,7,42,0,0,0,1,0
2020-08-05,49,1,6,43,0,0,0,1,0
2020-08-06,50,1,6,44,0,0,0,1,0
2020-08-07,49,1,5,44,0,0,0,0,0
2020-08-08,50,1,5,45,0,0,0,0,0
2020-08-09,50,1,5,45,0,0,0,0,0
2020-08-10,49,1,4,45,0,0,0,0,0
2020-08-11,50,1,4,46,0,0,0,0,0
2020-08-12,50,0,4,46,0,0,0,0,0
2020-08-13,51,0,4,47,0,0,0,0,0
2020-08-14,50,0,3,47,0,0,0,0,0
2020-08-15,50,0,3,47,0,0,0,0,0
2020-08-16,50,0,3,47,0,0,0,0,0
2020-08-17,51,0,3,48,0,0,0,0,0
2020-08-18,51,0,3,48,0,0,0,0,0
2020-08-19,50,0,2,48,0,0,0,0,0
2020-08-20,50,0,2,48,0,0,0,0,0
2020-08-21,51,0,2,49,0,0,0,0,0
2020-08-22,51,0,2,49,0,0,0,0,0
2020-08-23,51,0,2,49,0,0,0,0,0
2020-08-24,51,0,2,49,0,0,0,0,0
2020-08-25,51,0,2,49,0,0,0,0,0
2020-08-26,50,0,1,49,0,0,0,0,0
2020-08-27,51,0,1,50,0,0,0,0,0
2020-08-28,51,0,1,50,0,0,0,0,0
2020-08-29,51,0,1,50,0,0,0,0,0
2020-08-30,51,0,1,50,0,0,0,0,0
2020-08-31,51,0,1,50,0,0,0,0,0
2020-09-01,51,0,1,50,0,0,0,0,0
2020-09-02,51,0,1,50,0,0,0,0,0
2020-09-03,51,0,1,50,0,0,0,0,0
2020-09-04,51,0,1,50,0,0,0,0,0
2020-09-05,51,0,1,50,0,0,0,0,0
2020-09-06,51,0,1,50,0,0,0,0,0
2020-09-07,51,0,1,50,0,0,0,0,0
2020-09-08,52,0,1,51,0,0,0,0,0
2020-09-09,52,0,1,51,0,0,0,0,0
2020-09-10,52,0,1,51,0,0,0,0,0
2020-09-11,52,0,1,51,0,0,0,0,0
2020-09-12,51,0,0,51,0,0,0,0,0
2020-09-13,51,0,0,51,0,0,0,0,0
2020-09-14,51,0,0,51,0,0,0,0,0
2020-09-15,51,0,0,51,0,0,0,0,0
2020-09-16,51,0,0,51,0,0,0,0,0
2020-09-17,51,0,0,51,0,0,0,0,0
2020-09-18,51,0,0,51,0,0,0,0,0
2020-09-19,51,0,0,51,0,0,0,0,0
2020-09-20,51,0,0,51,0,0,0,0,0
2020-09-21,51,0,0,51,0,0,0,0,0
2020-09-22,51,0,0,51,0,0,0,0,0
2020-09-23,51,0,0,51,0,0,0,0,0
2020-09-24,51,0,0,51,0,0,0,0,0
2020-09-25,51,0,0,51,0,0,0,0,0
2020-09-26,51,0,0,51,0,0,0,0,0
2020-09-27,51,0,0,51,0,0,0,0,0
2020-09-28,51,0,0,51,0,0,0,0,0
2020-09-29,51,0,0,51,0,0,0,0,0
2020-09-30,51,0,0,51,0,0,0,0,0
2020-10-01,51,0,0,51,0,0,0,0,0
2020-10-02,51,0,0,51,0,0,0,0,0
2020-10-03,51,0,0,51,0,0,0,0,0
2020-10-04,51,0,0,51,0,0,0,0,0
2020-10-05,51,0,0,51,0,0,0,0,0
2020-10-06,51,0,0,51,0,0,0,0,0
2020-10-07,51,0,0,51,0,0,0,0,0
2020-10-08,51,0,0,51,0,0,0,0,0
2020-10-09,51,0,0,51,0,0,0,0,0
2020-10-10,51,0,0,51,0,0,0,0,0
2020-10-11,51,0,0,51,0,0,0,0,0
2020-10-12,51,0,0,51,0,0,0,0,0
2020-10-13,51,0,0,51,0,0,0,0,0
2020-10-14,51,0,0,51,0,0,0,0,0
2020-10-15,51,0,0,51,0,0,0,0,0
2020-10-16,51,0,0,51,0,0,0,0,0
2020-10-17,51,0,0,51,0,0,0,0,0
2020-10-18,51,0,0,51,0,0,0,0,0
2020-10-19,51,0,0,51,0,0,0,0,0
2020-10-20,51,0,0,51,0,0,0,0,0
2020-10-21,51,0,0,51,0,0,0,0,0
2020-10-22,51,0,0,51,0,0,0,0,0
2020-10-23,51,0,0,51,0,0,0,0,0
2020-10-24,51,0,0,51,0,0,0,0,0
2020-10-25,51,0,0,51,0,0,0,0,0
2020-10-26,51,0,0,51,0,0,0,0,0
2020-10-27,51,0,0,51,0,0,0,0,0
2020-10-28,51,0,0,51,0,0,0,0,0
2020-10-29,51,0,0,51,0,0,0,0,0
2020-10-30,51,0,0,51,0,0,0,0,0
2020-10-31,51,0,0,51,0,0,0,0,0
2020-11-01,51,0,0,51,0,0,0,0,0
2020-11-02,51,0,0,51,0,0,0,0,0
2020-11-03,51,0,0,51,0,0,0,0,0
2020-11-04,51,0,0,51,0,0,0,0,0
2020-11-05,51,0,0,51,0,0,0,0,0
2020-11-06,51,0,0,51,0,0,0,0,0
2020-11-07,51,0,0,51,0,0,0,0,0
2020-11-08,51,0,0,51,0,0,0,0,0
2020-11-09,51,0,0,51,0,0,0,0,0
2020-11-10,51,0,0,51,0,0,0,0,0
2020-11-11,51,0,0,51,0,0,0,0,0
2020-11-12,51,0,0,51,0,0,0,0,0
2020-11-13,51,0,0,51,0,0,0,0,0
2020-11-14,51,0,0,51,0,0,0,0,0
2020-11-15,51,0,0,51,0,0,0,0,0
2020-11-16,51,0,0,51,0,0,0,0,0
2020-11-17,51,0,0,51,0,0,0,0,0
2020-11-18,51,0,0,51,0,0,0,0,0
2020-11-19,51,0,0,51,0,0,0,0,0
2020-11-20,51,0,0,51,0,0,0,0,0
2020-11-21,51,0,0,51,0,0,0,0,0
2020-11-22,51,0,0,51,0,0,0,0,0
2020-11-23,51,0,0,51,0,0,0,0,0
2020-11-24,51,0,0,51,0,0,0,0,0
2020-11-25,51,0,0,51,0,0,0,0,0
2020-11-26,51,0,0,51,0,0,0,0,0
2020-11-27,51,0,0,51,0,0,0,0,0
2020-11-28,51,0,0,51,0,0,0,0,0
2020-11-29,51,0,0,51,0,0,0,0,0
2020-11-30,51,0,0,51,0,0,0,0,0
2020-12-01,51,0,0,51,0,0,0,0,0
2020-12-02,51,0,0,51,0,0,0,0,0
2020-12-03,51,0,0,51,0,0,0,0,0
2020-12-04,51,0,0,51,0,0,0,0,0
2020-12-05,51,0,0,51,0,0,0,0,0
2020-12-06,51,0,0,51,0,0,0,0,0
2020-12-07,51,0,0,51,0,0,0,0,0
2020-12-08,51,0,0,51,0,0,0,0,0
2020-12-09,51,0,0,51,0,0,0,0,0
2020-12-10,51,0,0,51,0,0,0,0,0
2020-12-11,51,0,0,51,0,0,0,0,0
2020-12-12,51,0,0,51,0,0,0,0,0
2020-12-13,51,0,0,51,0,0,0,0,0
2020-12-14,51,0,0,51,0,0,0,0,0
2020-12-15,51,0,0,51,0,0,0,0,0
2020-12-16,51,0,0,51,0,0,0,0,0
2020-12-17,51,0,0,51,0,0,0,0,0
2020-12-18,51,0,0,51,0,0,0,0,0
2020-12-19,51,0,0,51,0,0,0,0,0
2020-12-20,51,0,0,51,0,0,0,0,0
2020-12-21,51,0,0,51,0,0,0,0,0
2020-12-22,51,0,0,51,0,0,0,0,0
2020-12-23,51,0,0,51,0,0,0,0,0
2020-12-24,51,0,0,51,0,0,0,0,0
2020-12-25,51,0,0,51,0,0,0,0,0
2020-12-26,51,0,0,51,0,0,0,0,0
2020-12-27,51,0,0,51,0,0,0,0,0
2020-12-28,51,0,0,51,0,0,0,0,0
2020-12-29,51,0,0,51,0,0,0,0,0
2020-12-30,51,0,0,51,0,0,0,0,0
2020-12-31,51,0,0,51,0,0,0,0,0
2021-01-01,51,0,0,51,0,0,0,0,0
2021-01-02,51,0,0,51,0,0,0,0,0
2021-01-03,51,0,0,51,0,0,0,0,0
2021-01-04,51,0,0,51,0,0,0,0,0
2021-01-05,51,0,0,51,0,0,0,0,0
2021-01-06,51,0,0,51,0,0,0,0,0
2021-01-07,51,0,0,51,0,0,0,0,0
2021-01-08,51,0,0,51,0,0,0,0,0
2021-01-09,51,0,0,51,0,0,0,0,0
2021-01-10,51,0,0,51,0,0,0,0,0
2021-01-11,51,0,0,51,0,0,0,0,0
2021-01-12,51,0,0,51,0,0,0,0,0
2021-01-13,51,0,0,51,0,0,0,0,0
2021-01-14,51,0,0,51,0,0,0,0,0
2021-01-15,51,0,0,51,0,0,0,0,0
2021-01-16,51,0,0,51,0,0,0,0,0
2021-01-17,51,0,0,51,0,0,0,0,0
2021-01-18,51,0,0,51,0,0,0,0,0
2021-01-19,51,0,0,51,0,0,0,0,0
2021-01-20,51,0,0,51,0,0,0,0,0
2021-01-21,51,0,0,51,0,0,0,0,0
2021-01-22,51,0,0,51,0,0,0,0,0
2021-01-23,51,0,0,51,0,0,0,0,0
2021-01-24,51,0,0,51,0,0,0,0,0
2021-01-25,51,0,0,51,0,0,0,0,0
2021-01-26,51,0,0,51,0,0,0,0,0
2021-01-27,51,0,0,51,0,0,0,0,0
2021-01-28,51,0,0,51,0,0,0,0,0
2021-01-29,51,0,0,51,0,0,0,0,0
2021-01-30,51,0,0,51,0,0,0,0,0
2021-01-31,51,0,0,51,0,0,0,0,0
2021-02-01,51,0,0,51,0,0,0,0,0
2021-02-02,51,0,0,51,0,0,0,0,0
2021-02-03,51,0,0,51,0,0,0,0,0
2021-02-04,51,0,0,51,0,0,0,0,0
2021-02-05,51,0,0,51,0,0,0,0,0
2021-02-06,51,0,0,51,0,0,0,0,0
2021-02-07,51,0,0,51,0,0,0,0,0
2021-02-08,51,0,0,51,0,0,0,0,0
2021-02-09,51,0,0,51,0,0,0,0,0
2021-02-10,51,0,0,51,0,0,0,0,0
2021-02-11,51,0,0,51,0,0,0,0,0
2021-02-12,51,0,0,51,0,0,0,0,0
2021-02-13,51,0,0,51,0,0,0,0,0
2021-02-14,51,0,0,51,0,0,0,0,0
2021-02-15,51,0,0,51,0,0,0,0,0
2021-02-16,51,0,0,51,0,0,0,0,0
2021-02-17,51,0,0,51,0,0,0,0,0
2021-02-18,51,0,0,51,0,0,0,0,0
2021-02-19,51,0,0,51,0,0,0,0,0
2021-02-20,51,0,0,51,0,0,0,0,0
2021-02-21,51,0,0,51,0,0,0,0,0
2021-02-22,51,0,0,51,0,0,0,0,0
2021-02-23,51,0,0,51,0,0,0,0,0
2021-02-24,51,0,0,51,0,0,0,0,0
2021-02-25,51,0,0,51,0,0,0,0,0
2021-02-26,51,0,0,51,0,0,0,0,0
2021-02-27,51,0,0,51,0,0,0,0,0
2021-02-28,51,0,0,51,0,0,0,0,0
2021-03-01,51,0,0,51,0,0,0,0,0
2021-03-02,51,0,0,51,0,0,0,0,0
2021-03-03,51,0,0,51,0,0,0,0,0
2021-03-04,51,0,0,51,0,0,0,0,0
2021-03-05,51,0,0,51,0,0,0,0,0
2021-03-06,51,0,0,51,0,0,0,0,0
2021-03-07,51,0,0,51,0,0,0,0,0
2021-03-08,51,0,0,51,0,0,0,0,0
2021-03-09,51,0,0,51,0,0,0,0,0
2021-03-10,51,0,0,51,0,0,0,0,0
2021-03-11,51,0,0,51,0,0,0,0,0
2021-03-12,51,0,0,51,0,0,0,0,0
2021-03-13,51,0,0,51,0,0,0,0,0
2021-03-14,51,0,0,51,0,0,0,0,0
2021-03-15,51,0,0,51,0,0,0,0,0
2021-03-16,51,0,0,51,0,0,0,0,0
2021-03-17,51,0,0,51,0,0,0,0,0
2021-03-18,51,0,0,51,0,0,0,0,0
2021-03-19,51,0,0,51,0,0,0,0,0
2021-03-20,51,0,0,51,0,0,0,0,0
2021-03-21,51,0,0,51,0,0,0,0,0
2021-03-22,51,0,0,51,0,0,0,0,0
2021-03-23,51,0,0,51,0,0,0,0,0
2021-03-24,51,0,0,51,0,0,0,0,0
2021-03-25,51,0,0,51,0,0,0,0,0
2021-03-26,51,0,0,51,0,0,0,0,0
2021-03-27,51,0,0,51,0,0,0,0,0
2021-03-28,51,0,0,51,0,0,0,0,0
2021-03-29,51,0,0,51,0,0,0,0,0
2021-03-30,51,0,0,51,0,0,0,0,0
2021-03-31,51,0,0,51,0,0,0,0,0
2021-04-01,51,0,0,51,0,0,0,0,0
2021-04-02,51,0,0,51,0,0,0,0,0
2021-04-03,51,0,0,51,0,0,0,0,0
2021-04-04,51,0,0,51,0,0,0,0,0
2021-04-05,51,0,0,51,0,0,0,0,0
2021-04-06,51,0,0,51,0,0,0,0,0
2021-04-07,51,0,0,51,0,0,0,0,0
2021-04-08,51,0,0,51,0,0,0,0,0
2021-04-09,51,0,0,51,0,0,0,0,0
2021-04-10,51,0,0,51,0,0,0,0,0
2021-04-11,51,0,0,51,0,0,0,0,0
2021-04-12,51,0,0,51,0,0,0,0,0
2021-04-13,51,0,0,51,0,0,0,0,0
2021-04-14,51,0,0,51,0,0,0,0,0
2021-04-15,51,0,0,51,0,0,0,0,0
2021-04-16,51,0,0,51,0,0,0,0,0
2021-04-17,51,0,0,51,0,0,0,0,0
2021-04-18,51,0,0,51,0,0,0,0,0
2021-04-19,51,0,0,51,0,0,0,0,0
2021-04-20,51,0,0,51,0,0,0,0,0
2021-04-21,51,0,0,51,0,0,0,0,0
2021-04-22,51,0,0,51,0,0,0,0,0
2021-04-23,51,0,0,51,0,0,0,0,0
2021-04-24,51,0,0,51,0,0,0,0,0
2021-04-25,51,0,0,51,0,0,0,0,0
2021-04-26,51,0,0,51,0,0,0,0,0
2021-04-27,51,0,0,51,0,0,0,0,0
2021-04-28,51,0,0,51,0,0,0,0,0
2021-04-29,51,0,0,51,0,0,0,0,0
2021-04-30,51,0,0,51,0,0,0,0,0
2021-05-01,51,0,0,51,0,0,0,0,0
2021-05-02,51,0,0,51,0,0,0,0,0
2021-05-03,51,0,0,51,0,0,0,0,0
2021-05-04,51,0,0,51,0,0,0,0,0
2021-05-05,51,0,0,51,0,0,0,0,0
2021-05-06,51,0,0,51,0,0,0,0,0
2021-05-07,51,0,0,51,0,0,0,0,0
2021-05-08,51,0,0,51,0,0,0,0,0
2021-05-09,51,0,0,51,0,0,0,0,0
2021-05-10,51,0,0,51,0,0,0,0,0
2021-05-11,51,0,0,51,0,0,0,0,0
2021-05-12,51,0,0,51,0,0,0,0,0
2021-05-13,51,0,0,51,0,0,0,0,0
2021-05-14,51,0,0,51,0,0,0,0,0
2021-05-15,51,0,0,51,0,0,0,0,0
2021-05-16,51,0,0,51,0,0,0,0,0
2021-05-17,51,0,0,51,0,0,0,0,0
2021-05-18,51,0,0,51,0,0,0,0,0
2021-05-19,51,0,0,51,0,0,0,0,0
2021-05-20,51,0,0,51,0,0,0,0,0
2021-05-21,51,0,0,51,0,0,0,0,0
2021-05-22,51,0,0,51,0,0,0,0,0
2021-05-23,51,0,0,51,0,0,0,0,0
2021-05-24,51,0,0,51,0,0,0,0,0
2021-05-25,51,0,0,51,0,0,0,0,0
2021-05-26,51,0,0,51,0,0,0,0,0
2021-05-27,51,0,0,51,0,0,0,0,0
2021-05-28,51,0,0,51,0,0,0,0,0
2021-05-29,51,0,0,51,0,0,0,0,0
2021-05-30,51,0,0,51,0,0,0,0,0
2021-05-31,51,0,0,51,0,0,0,0,0
2021-06-01,51,0,0,51,0,0,0,0,0
2021-06-02,51,0,0,51,0,0,0,0,0
2021-06-03,51,0,0,51,0,0,0,0,0
2021-06-04,51,0,0,51,0,0,0,0,0
2021-06-05,51,0,0,51,0,0,0,0,0
2021-06-06,51,0,0,51,0,0,0,0,0
2021-06-07,51,0,0,51,0,0,0,0,0
2021-06-08,51,0,0,51,0,0,0,0,0
2021-06-09,51,0,0,51,0,0,0,0,0
2021-06-10,51,0,0,51,0,0,0,0,0
2021-06-11,51,0,0,51,0,0,0,0,0
2021-06-12,51,0,0,51,0,0,0,0,0
2021-06-13,51,0,0,51,0,0,0,0,0
2021-06-14,51,0,0,51,0,0,0,0,0
2021-06-15,51,0,0,51,0,0,0,0,0
2021-06-16,51,0,0,51,0,0,0,0,0
2021-06-17,51,0,0,51,0,0,0,0,0
2021-06-18,51,0,0,51,0,0,0,0,0
2021-06-19,51,0,0,51,0,0,0,0,0
2021-06-20,51,0,0,51,0,0,0,0,0
2021-06-21,51,0,0,51,0,0,0,0,0
2021-06-22,51,0,0,51,0,0,0,0,0
2021-06-23,51,0,0,51,0,0,0,0,0
2021-06-24,51,0,0,51,0,0,0,0,0
2021-06-25,51,0,0,51,0,0,0,0,0
2021-06-26,51,0,0,51,0,0,0,0,0
2021-06-27,51,0,0,51,0,0,0,0,0
2021-06-28,51,0,0,51,0,0,0,0,0
2021-06-29,51,0,0,51,0,0,0,0,0
2021-06-30,51,0,0,51,0,0,0,0,0
2021-07-01,51,0,0,51,0,0,0,0,0
2021-07-02,51,0,0,51,0,0,0,0,0
2021-07-03,51,0,0,51,0,0,0,0,0
